#_###########################################################################################
#___________________________________________________________________________________________#
#___________________________________________________________________________________________#
#___________________________________________________________________________________________#
#___________________________________________________________________________________________#
#___________________________________________________________________________________________#
#___________________________________________________________________________________________#
#___________________________________________________________________________________________#
#___________________________________________________________________________________________#
#___________________________________________________________________________________________#
#___________________________________________________________________________________________#
#___________________________________________________________________________________________#
#___________________________________________________________________________________________#
#___________________________________________________________________________________________#
#___________________________________________________________________________________________#
#___________________________________________________________________________________________#
#___________________________________________________________________________________________#
#___________________________________________________________________________________________#
#___________________________________________________________________________________________#
#___________________________________________________________________________________________#
#___________________________________________________________________________________________#
#___________________________________________________________________________________________#
#___________________________________________________________________________________________#
#___________________________________________________________________________________________#
#___________________________________________________________________________________________#
#___________________________________________________________________________________________#
#___________________________________________________________________________________________#
#___________________________________________________________________________________________#
#___________________________________________________________________________________________#
#___________________________________________________________________________________________#
#___________________________________________________________________________________________#
#___________________________________________________________________________________________#
#___________________________________________________________________________________________#
#___________________________________________________________________________________________#
#___________________________________________________________________________________________#
#___________________________________________________________________________________________#
#___________________________________________________________________________________________#
#___________________________________________________________________________________________#
#___________________________________________________________________________________________#
#___________________________________________________________________________________________#
#___________________________________________________________________________________________#
#___________________________________________________________________________________________#
#___________________________________________________________________________________________#
#___________________________________________________________________________________________#
#___________________________________________________________________________________________#
#___________________________________________________________________________________________#
#___________________________________________________________________________________________#
#___________________________________________________________________________________________#
#___________________________________________________________________________________________#
#___________________________________________________________________________________________#
#___________________________________________________________________________________________#
#___________________________________________________________________________________________#
#___________________________________________________________________________________________#
#___________________________________________________________________________________________#
#___________________________________________________________________________________________#
#___________________________________________________________________________________________#
###########################################################################################_#
