#############################################_##################################
###########################_#################__________________________________#
###########################_#################_################################_#
###########################___________________################################_#
#_____________________________________________################################_#
#_####################___####################_################################_#
#_####################___####################_################################_#
#_####################___####################_################################_#
#_####################___####################__________________________________#
#_####################___####################_#_########################_#######
#_####################___####################_#_########################_#######
#_####################___####################_#_########################_#######
#_##################__________________________#_########################_#######
#_##################_################___________########################_#######
#_##################_################_____##____########################_#######
#_##################_################_____##____########################_#######
#_##################_################_____##____########################_#######
#_##################_################_____##____########################_#######
#_##################_################_____##____########################_#######
#_##################_################___________########################_#######
#_##################_##########################_########################_#######
#_##################_##########################_########################_#######
#_##################_##########################_########################_#######
#_##################_##########################_########################_#######
#_##################_##########################_########################_#######
#_##################_##########################_########################_#######
#_##################_##########################_########################_#######
#_##################_##########################_########################_#######
#_##################_____________________________________###############_#######
#_##################_###################################################_#######
#_##################_###################################################_#######
#_##################_###################################################_#######
#_##################_###################################################_#######
#_##################_###################################################_#######
#_##################_###################################################_#######
#_##################_###################################################_#######
#_##################_###################################################_#######
#_##################_###################################################_#######
#_##################_###################################################_#######
#_##################_###################################################_#######
#_##################_###################################################_#######
#_##################_###################################################_#######
#_##################_###################################################_#######
#_##################_###################################################_#######
#_##################_##########__________________________________________#######
####################_###########################################################
