################################################_###############################
###########################_#################____#############################_#
###########################_#################_################################_#
###########################_#################_################################_#
#_____________________________________________################################_#
#_######################_####################_################################_#
#_######################_####################_################################_#
#_######################_####################_################################_#
#_######################_####################__________________________________#
#_######################_####################_##########################_#######
#_###########################################_##########################_#######
#_###########################################_##########################_#######
#_##################__________________________##########################_#######
#_##################_################_##################################_#######
#_##################_################_##################################_#######
#_##################_################_##################################_#######
#_##################_################_##################################_#######
#_##################_################_##################################_#######
#_##################_################_##################################_#######
#_##################_################___________########################_#######
#_##################_###################################################_#######
#_##################_###################################################_#######
#_##################_###################################################_#######
#_##################_###################################################_#######
#_##################_###################################################_#######
#_##################_###################################################_#######
#_##################_###################################################_#######
#_##################_###################################################_#######
#_##################_____________________________________###############_#######
#_##################_###################################################_#######
#_##################_###################################################_#######
#_##################_###################################################_#######
#_##################_###################################################_#######
#_##################_###################################################_#######
#_##################_###################################################_#######
#_##################_###################################################_#######
#_##################_###################################################_#######
#_##################_###################################################_#######
#_##################_###################################################_#######
#_##################_###################################################_#######
#_##################_###################################################_#######
#_##################_###################################################_#######
#_##################_###################################################_#######
#_##################_###################################################_#######
#_##################_##########__________________________________________#######
####################_###########################################################
